wwwwwww
www00ww
w00X0ww
w00000w
w0wX00w
w00000w
wwwwwww
2,1
4,2
4,3